111111111
100000C01
10P000001
11C111111
1010000E1
111111111